X X X X X X X X X X X X X X X X X X X X
X . . . . . . . . . . . . . . . X X X X
X . S . . . . . . . . . . . . . . . X X
X . . . . . X X X X . . . . . . S . X X
X X X X X X X . . . . . . . . . . . X X
X X . . . . . . . . . . . . . X X X X X
X X . . . . . . . X X X X X X X . . . X
X X . . . . . . . . . . . . . . . C . X
X X X . . . . . . . . . . . . . . . . X
X X X X X X X X X X X X X X X X X X X X