r - - - - - - - - - - - - - - - - - - q
( . . . . . . . . . . . . . . . . . . )
( . . . . . . . . . . . . . . . . . . )
( . . . . . . . . . . . . . . . . . . )
( . . . . . . . . . . . . . . . . . . )
( . . . . . . . . . . . . . . . . . . )
( . . . . . . . . . . . . . . ^ . . . )
( . . . H . . . = . . . . . < . > . . )
( . . . . . . . . . . . . . . V . . . )
L _ _ _ _ _ _ _ _ _ _ _ _ _ _ _ _ _ _ J